SO ./path_to_the_south_texture
F 222,100,100
C 225,030,12
WE ./path_to_the_west_texture
EA ./path_to_the_east_texture
NO ./path_to_the_north_texture






        111111111111 1111111111111
        1000000000000000000000001
        1011000001100000000000001
        1001000000000000000000001
111111111011000001110000000000001
100000000011000001110111111111111
11110111111111011100000010001
11110111111111011101010010001
11000000110101011100000010001
10000000000000001100000010001
10000000000000001101010010001
11000001110101011111011110N0111
11110111110101101111010001
1111111 111111111111111111