WE ./path_to_the_west_texture         
EA ./path_to_the_east_texture
NO ./path_to_the_north_texturef
SO ./pth_to_the_south_texture




C 225,030,0     
F 222,100,100


11111111111111111111111111111111111111111111111111
10000011010111011001010011000000000000000000000001
10000011010111011000010011000000000000000000000001
10000011010111011000000011000000000000000000000001
10000011010111011001010011000000000000000000000001
10000010000001011001010011000000000000000000000001
10000010000001011111011111000000000000000000000001
10000000000001011000000011000000000000000000000001
10000000000001011000000011000000000000000000000001
10000010000001011010101011000000011000000110000001
11101111101111011000000011000000000111111000000001
11101111101111011000000011000000000111111000000001
10000010000011011111011111000000011000000110000001
10000011000011011111011111000000000000000000000001
10000010000000000000000000000000000000000000000001
10000011000011011110101111000000000000W00000000001
10000010000011011110101111000000000000000000000001
10000011000011011000000011000000000000000000000001
10000010000011011000000011000000000000000000000001
10000011101111011000000011000000000000000000000001
10000011101111000000000011000000000000000000000001
10000000000001011000000011000000000000000000000001
10000000000001011000000011000000000000000000000001
10000000000001011000101011000000000000000000000001
11111111111111111111111111111111111111111111111111