WE ./path_to_the_west_texture         
EA ./path_to_the_east_texture
NO ./path_to_the_north_texturef
SO ./pth_to_the_south_texture




C 225,030,0     
F 222,100,100




        1111111111111111111111111111111111
        1000000000000000000000000000000001
        1000000000000000000000110000000001
        10011111111100000000000000000000001
111111110000000000000000000000000000000011
100000000000000000000000000000000111111111
100000000000000000000001000010000111
1000000000000000000000001111000000001
100000000000000000000001000010000111
100000000000000000000000000W00000111
10000000000111111000000000000000001
100000000001     1000000000000000001
111111111111     1111111111111111111